                                           
       ..................................  
   ......................................  
 ........................................  
 ..........................................
 ..........................................
 ........................................  
 ........................................  
 ...ppppp................................  
 ...ppppp................................  
 ...ppppp................................  
 ...ppppp................................  
 ...ppppp................................  
 ........................................  
 ........................................  
 ........................................  
 ........................................  
 ........................................  
 ........................................  
         ........                          