                               
       ...........             
   ......................      
 ............................  
 ..............................
 ..............................
  ..........................   
     ...................       
         ........              