                                             
                   ....................      
               ...........................   
     ......................................  
............................................ 
............................................ 
                                             